

NO ./assets/wolf3d/grey_stone.XPM
SO ./assets/wolf3d/redbrick.XPM
EA ./assets/wolf3d/purple_stone.XPM
WE ./assets/wolf3d/eagle.XPM
S ./Wolf_tex/textures/xpm/barrel.xpm
C 255,200,160
F 122,122,122

11111111111111111
10000000000000001
10000000000000001
10111000000000001
10000000000000001
10000000000000001
10000000W00000001
10000000000000001
10000000000000001
10000000000011111
10000000000000001
10000000000000001
11111111111111111
